##########
#.##...#.#
..########
#.##.....#
#.##.#.###
#....#....
#.####.###
#.########
#........#
########.#
