#.########
#.#.####.#
#........#
########.#
########.#
##.......#
##.#######
##.#...###
##...#....
##########
