##########
###...####
##...#....
#.####.###
..##....##
#..#.##.##
#..#.#..##
#.#..#.#.#
#...#....#
#####.####
