##.#######
##..###.##
#...###.##
##..###.##
#.....#.##
##.##...##
###..##.##
##...##.##
##...##.##
#######.##
