## #######
##  ### ##
#   ### ##
##  ### ##
#     # ##
## ##   ##
###  ## ##
##   ## ##
##   ## ##
####### ##
