##########
#........#
#..###..##
#...##...#
#...##...#
....##..##
#.#..#...#
#...##...#
#........#
##########
