##########
#        #
#  ###  ##
#   ##   #
#   ##   #
    ##  ##
# #  #   #
#   ##   #
#        #
##########
