##########
# ##   # #
  ########
# ##     #
# ## # ###
#    #
# #### ###
# ########
#        #
######## #
