# ########
# # #### #
#        #
######## #
######## #
##       #
## #######
## #   ###
##   #
##########
