##########
###   ####
##   #
# #### ###
  ##    ##
#  # ## ##
#  # #  ##
# #  # # #
#   #    #
##### ####
